24 30
38 10 14 10 48 119 109 109 110 107 0 72 86 74 32 0 0 56 57 57 57 57 57 58
35 11 35 100 101 36 12 38 113 3 50 80 95 82 1 107 1 64 76 85 75 0 25 66
10 37 9 102 103 10 100 101 119 109 110 88 89 90 3 19 3 64 66 71 64 4 3 66
10 10 15 38 36 11 102 103 51 52 113 25 1 1 3 1 3 64 66 79 64 5 4 66
36 39 12 36 38 8 35 117 115 115 116 1 30 31 107 20 1 64 66 4 64 104 105 66
10 10 11 14 8 36 117 116 2 0 43 44 3 3 3 2 5 0 74 2 72 85 83 74
8 37 39 11 35 117 116 32 4 50 4 121 122 123 0 4 33 1 1 21 80 71 91 82
36 117 115 115 115 116 0 0 107 34 124 125 126 127 128 3 1 5 21 50 88 89 89 90
12 116 50 0 21 0 121 122 123 3 129 130 131 132 133 2 107 0 4 30 31 1 0 4
57 3 43 44 1 124 125 126 127 128 134 135 136 137 138 0 4 2 1 0 2 21 32 4
18 66 0 3 1 129 130 131 132 133 4 50 139 140 28 29 121 122 123 31 20 1 5 21
17 66 1 20 2 134 135 136 137 138 34 1 0 18 4 124 125 126 127 128 2 107 4 4
3 66 2 3 17 0 107 139 140 0 4 28 29 0 2 129 130 131 132 133 0 3 18 1
73 74 2 107 0 2 21 1 0 34 3 5 3 2 0 134 135 136 137 138 2 3 107 108
97 82 3 5 20 21 34 1 3 2 121 122 123 3 24 5 2 139 140 21 4 20 108 120
59 90 3 0 2 5 0 107 0 124 125 126 127 128 2 0 34 0 3 3 3 5 111 48
0 28 29 121 122 123 3 2 5 129 130 131 132 133 2 121 122 123 28 29 4 0 114 118
1 4 124 125 126 127 128 2 107 134 135 136 137 138 124 125 126 127 128 0 121 122 123 114
2 34 129 130 131 132 133 32 30 5 3 139 140 0 129 130 131 132 133 124 125 126 127 128
3 2 134 135 136 137 138 17 2 30 31 1 21 0 134 135 136 137 138 129 130 131 132 133
0 1 3 21 139 140 21 1 107 2 2 107 2 17 2 25 139 140 3 134 135 136 137 140
20 3 107 33 1 0 24 3 1 1 28 29 0 121 122 123 5 2 2 0 5 139 140 0
0 32 0 2 1 121 122 123 25 0 0 3 124 125 126 127 128 1 33 107 2 1 5 30
3 107 108 110 124 125 126 127 128 5 107 1 129 130 131 132 133 24 5 2 4 107 34 4
1 0 114 116 129 130 131 132 133 32 4 1 134 135 136 137 138 2 3 25 5 2 1 5
31 3 20 107 134 135 136 137 138 121 122 123 2 21 139 140 0 1 4 121 122 123 32 0
5 0 4 0 1 3 139 140 124 125 126 127 128 25 3 3 107 3 124 125 126 127 128 28
1 30 31 108 109 110 2 20 129 130 131 132 133 2 3 25 2 20 129 130 131 132 133 2
4 25 1 111 38 113 2 0 134 135 136 137 138 5 33 1 3 3 134 135 136 137 138 30
32 0 0 114 115 116 28 29 1 2 139 140 1 3 3 17 1 34 3 5 139 140 2 5