24 30
0 1 2 3 4 5 11 6 7 8 9 10 11 0 1 2 3 4 5 11 6 7 8 9
9 10 11 0 1 52 3 4 5 12 14 13 15 0 1 2 3 4 5 89 6 7 8 9
0 1 48 2 3 4 2 5 11 20 29 31 26 6 7 8 9 10 2 2 2 2 2 3
6 7 50 48 6 7 8 9 10 16 17 17 28 0 1 2 89 4 2 3 3 3 2 3
4 0 51 50 3 6 7 89 9 10 11 6 2 2 3 3 3 3 3 3 5 4 5 2
5 6 7 8 0 52 2 5 8 9 10 52 2 3 11 6 7 8 9 10 5 52 4 5
4 52 0 1 3 4 11 6 5 8 9 10 11 0 3 4 89 0 1 2 3 4 5 4
2 3 6 7 8 9 0 1 0 1 2 3 52 0 5 6 4 54 55 56 57 58 0 2
0 1 2 2 3 5 3 89 11 2 3 4 5 2 3 4 5 59 60 61 62 63 1 2
11 2 3 52 3 6 7 0 1 89 8 9 10 11 6 7 8 64 65 66 67 68 2 3
6 7 0 1 3 3 11 6 4 79 0 1 51 3 52 2 3 69 70 71 72 73 2 3
0 79 1 0 2 89 4 5 0 7 8 9 50 9 10 11 6 74 75 76 77 78 3 3
0 0 1 2 3 4 5 0 7 8 9 10 11 6 1 3 10 4 2 3 8 9 10 11
6 7 0 1 2 3 9 2 3 4 2 3 88 82 83 12 15 6 7 8 9 10 11 6
0 1 2 3 4 5 0 79 3 51 48 7 87 81 84 22 23 13 13 15 1 88 82 83
6 7 0 52 2 3 4 2 3 50 49 1 86 80 85 16 18 18 17 28 7 87 81 84
0 1 2 3 4 5 0 7 8 9 79 10 11 6 1 2 3 4 5 0 7 86 80 85
6 79 8 9 10 79 6 1 48 3 4 5 0 7 8 9 10 11 6 1 2 3 4 5
2 3 4 5 0 7 8 9 50 11 6 52 2 3 4 5 88 82 83 9 10 48 6 79
8 9 10 11 6 1 2 3 4 5 0 1 2 79 4 5 87 81 84 3 4 49 0 1
12 13 15 0 52 2 3 4 88 82 83 0 1 2 3 4 86 80 85 8 9 10 11 6
16 18 27 4 5 0 1 2 87 81 84 2 3 4 5 0 1 2 3 4 5 0 7 8
12 14 27 10 11 6 7 8 86 80 85 9 10 11 6 7 8 9 10 11 6 1 2 3
16 17 28 10 11 6 7 8 9 10 11 6 52 8 9 10 79 6 7 8 9 10 11 6
0 1 2 3 4 5 11 52 7 8 9 10 11 6 7 8 9 10 11 89 8 9 10 11
6 7 8 79 10 11 6 7 8 12 13 14 14 13 13 14 13 15 0 1 2 3 4 5
3 4 5 0 1 2 3 4 5 20 29 30 31 32 33 34 35 25 6 7 8 9 10 11
9 10 11 6 7 8 9 10 11 22 36 37 38 39 40 47 43 26 1 2 3 4 5 0
0 1 2 3 4 52 0 1 2 21 40 47 39 37 38 46 44 27 7 8 9 10 52 6
6 7 8 9 10 11 6 7 8 16 17 17 18 18 17 17 17 28 1 2 3 4 5 0