20 20
0 1 2 3 4 5 41 42 43 42 43 42 42 43 42 43 42 43 43 44
12 0 40 40 3 4 5 13 14 2 3 4 5 12 13 2 3 4 5 0
12 14 0 40 40 40 4 5 13 11 14 13 13 14 12 13 14 14 0 2
12 14 13 40 40 40 40 4 5 14 13 12 14 14 14 14 14 0 1 2
12 14 13 10 0 1 2 3 4 52 14 14 12 14 14 14 0 1 2 3
12 11 13 14 10 13 1 49 46 50 49 50 5 14 14 0 1 2 3 4
12 11 11 4 5 45 46 49 52 52 49 52 48 14 0 1 2 3 4 5
11 5 11 11 2 51 49 50 52 49 53 49 14 0 1 2 3 4 5 9
10 11 12 11 5 5 47 53 48 47 46 53 0 1 2 3 4 5 9 10
9 10 11 5 5 0 1 2 3 4 5 40 40 5 5 14 5 9 10 11
14 13 5 14 11 9 10 11 12 13 14 14 40 5 11 14 9 10 11 14
12 14 11 11 11 14 11 11 12 14 14 14 13 11 11 13 36 37 37 38
13 13 14 13 12 13 13 11 11 12 12 14 11 11 13 13 6 7 8 18
12 13 13 40 40 12 12 12 13 13 12 12 11 13 13 13 15 16 17 18
12 12 40 40 40 14 13 12 12 12 12 11 14 12 14 5 24 25 26 34
11 40 40 12 12 40 14 14 13 12 14 9 9 1 1 2 41 42 43 44
10 11 11 11 12 40 12 13 13 13 9 9 11 0 0 1 1 2 2 5
10 10 10 11 12 40 40 13 12 9 14 11 12 13 14 0 0 1 1 2
13 13 13 13 14 14 11 11 9 10 11 12 13 14 9 10 0 0 0 1
13 13 14 36 37 38 39 9 10 11 12 13 14 9 10 11 12 13 0 0